################
#S   #     #   #
######     #   #
#       ####   #
#  #      ##   #
#  #           #
#  #  #   ######
#  #  #   #   E#
#  #### ###  ###
#              #
################