################
S        % #   #
######     #   #
#       ####   #
#  ##1##  ##   #
#  #           #
#  #  #   ######
#  #  #   #   E#
#  #### #### ###
#              #
################

1%
