################
#E C   #  # %  #
####   A  ######
#  *   #  #    #
########  #    #
#  $      B    #
#D#########    #
#              #
#    #### ##   #
^    #     #  S#
################

A$
B%
C*
D^
