################
#E     #  #    #
####      #    #
#      #  #    #
########  #    #
#              #
###########    #
#              #
#    #### ##   #
#    #     #  S#
################