################
#S         #   #
######     #   #
#       ####   #
#  # %##  ##   #
#  #      1    #
#  #  #   ######
#  #  #   #   E#
#  #### ###  ###
#    $      2  #
################

1%


2$