################
#E C   #  #    #
####   A  ###D##
#  *   #  #    #
########  #    #
#  $      B    #
###########    #
#              #
#    #### ##   #
#   ^#%    #  S#
################

A$
B%
C*
D^
