##################
#E     #  #      #
####      #      #
#      #  #      #
########  #      #
#                #
###########      #
#                #
#    #### ##     #
#    #     #    S#
##################
##################

