################
#S        %#   #
######1#####   #
#       ####   #
#  ## ##  ##   #
#  #           #
#  #  #   ######
#  # $#   #    #
#  #### ###  ###
#   2         E#
################

1%


2$