################
S         #  $ #
######  %  #   #
#       ####   #
#  ##1##  ##4###
#  #   ^       #
#  #  #   ######
#  #  #       E#
#  #########3###
#   2        @ #
################

1%
2$
3@
4^
