################
S          #   #
######     #   #
#       ####   #
#  ##%##  ##   #
#  #      1    #
#  #  #   ######
# 3#  #   #   E#
#  #### #### ###
#    $        2#
################

1%
3 
2$